9 9 9 9 9 9 4 4 9 9 9 9 9 9 9 9
9 4 4 4 4 4 4 4 4 4 4 4 4 4 4 9
9 4 4 4 4 4 9 2 2 4 4 4 4 4 4 9
9 4 4 4 4 4 2 2 2 2 2 9 4 4 4 9
9 4 4 4 4 4 2 2 2 2 2 4 4 4 4 9
4 4 4 4 4 4 4 2 2 2 4 4 4 4 4 9
4 4 4 4 4 9 4 4 4 9 4 4 4 4 4 9
9 4 4 4 4 4 4 4 4 4 4 4 4 4 4 9
9 4 4 4 4 4 4 4 4 4 4 4 4 4 4 9
9 4 4 4 4 4 4 4 4 4 4 4 4 4 4 9
9 4 4 4 4 4 4 4 4 4 4 4 4 4 4 9
9 9 9 9 9 9 4 4 9 9 9 9 9 9 9 9